MKXU IDKMI DM BDASKMI NLU XCPJNDICFQ! K VDMGUC KW PDT GKG NLKB HP LFMG DC TBUG PDTC CUBDTCXUB. K'Q BTCU MDV PDT VFMN F WAFI BD LUCU KN KB WAFI GDKMINLKBHPLFMGKBQDCUWTMNLFMFMDMAKMUNDDA


K = i
Q = m
B = s
N = t
L = h

BTCU sure
NLU the
TBUG user

T = u
C = r
U = e

//hint: X = y
----------

W = f

F = a

Miye IDiMI DM sDASiMI the yrPJtDIrFm! i VDMGer if PDu GiG this HP hEMG Dr user PDur CesDuryes. i'm sure MDV PDu VaMt fAaI sD here it is fAaI GDKMINLKBHPLFMGKBQDCUWTMNLFMFMDMAKMUNDDA

A = l
I = g

Miye gDiMI DM sDlSiMg the yrPJtDIrFm! i VDMGer if PDu GiG this HP hEMG Dr user PDur CesDuryes. i'm sure MDV PDu VaMt flag sD here it is flag GDKMINLKBHPLFMGKBQDCUWTMNLFMFMDMAKMUNDDA

P = y
D = o
S = v
M = n

X = c
J = p

nice going on solving the cryptogram! i VonGer if you GiG this Hy hFnG or user your resources. i'm sure noV you Vant flag is here it is flag GDKMINLKBHPLFMGKBQDCUWTMNLFMFMDMAKMUNDDA

V = w
G = d
H = b

nice going on solving the cryptogram! i wonder if you did this by hand or user your resources. i'm sure now you want flag is here it is flag GDKMINLKBHPLFMGKBQDCUWTMNLFMFMDMAKMUNDDA

